MULakeNumber,date,dateTime,depth_m,verticalPosition_m,temp_degC,doConcentration_mgpL,doSaturation_percent,chlorophyll_RFU,phycocyaninBGA_RFU,phycoerythrinTAL_RFU,turbidity_FNU,pH,orp_mV,specificConductivity_uSpcm,salinity_psu,tds_mgpL,waterPressure_barA,latitude,longitude,altitude_m,barometerAirHandheld_mbars
181,2019-07-08,2019-07-08T17:47:39Z,0.072,0.101,28.715,10.1,130.7,0.74,0.7,NA,4.36,8.91,72.3,205.9,0.1,134,0.0069406641262928686,NA,NA,NA,976.8000000000001
181,2019-07-08,2019-07-08T17:47:40Z,0.143,0.17,28.716,10.1,130.7,0.8,0.69,NA,4.51,8.91,72.2,205.8,0.1,134,0.013813282525857378,NA,NA,NA,976.8000000000001
181,2019-07-08,2019-07-08T17:47:41Z,0.2,0.202,28.716,10.11,130.9,0.79,0.76,NA,4.55,8.91,72.2,205.8,0.1,134,0.019256940664126292,NA,NA,NA,976.8000000000001
181,2019-07-08,2019-07-08T17:47:42Z,0.224,0.241,28.716,10.11,130.9,0.79,0.75,NA,4.65,8.91,72.3,206,0.1,134,0.02157049537289058,NA,NA,NA,976.8000000000001
181,2019-07-08,2019-07-08T17:47:43Z,0.28,0.3,28.716,10.11,130.9,0.79,0.72,NA,4.74,8.91,72.5,206,0.1,134,0.02694610778443114,NA,NA,NA,976.8000000000001
181,2019-07-08,2019-07-08T17:47:44Z,0.328,0.344,28.716,10.12,130.9,0.77,0.76,NA,4.41,8.91,72.5,205.9,0.1,134,0.03157321720195972,NA,NA,NA,976.8000000000001
181,2019-07-08,2019-07-08T17:47:45Z,0.389,0.433,28.716,10.12,130.9,0.77,0.75,NA,4.54,8.91,72.3,206,0.1,134,0.03756124115405553,NA,NA,NA,976.8000000000001
181,2019-07-08,2019-07-08T17:47:46Z,0.52,0.607,28.715,10.11,130.9,0.77,0.78,NA,4.91,8.91,72.3,206,0.1,134,0.050149700598802395,NA,NA,NA,976.8000000000001
181,2019-07-08,2019-07-08T17:47:47Z,0.735,0.741,28.712,10.11,130.8,0.79,0.8,NA,4.97,8.91,72.4,205.9,0.1,134,0.07090364725095265,NA,NA,NA,976.8000000000001
181,2019-07-08,2019-07-08T17:47:51Z,0.851,0.897,28.704,10.11,130.8,0.8,0.88,NA,4.81,8.91,72.6,205.8,0.1,134,0.08206314643440392,NA,NA,NA,976.8000000000001
181,2019-07-08,2019-07-08T17:47:52Z,0.924,0.918,28.698,10.1,130.7,0.83,0.88,NA,4.53,8.91,72.6,206,0.1,134,0.08907185628742514,NA,NA,NA,976.8000000000001
181,2019-07-08,2019-07-08T17:47:53Z,0.936,0.959,28.693,10.09,130.6,0.82,0.88,NA,4.4,8.91,72.6,206,0.1,134,0.0902286336418073,NA,NA,NA,976.8000000000001
181,2019-07-08,2019-07-08T17:47:54Z,1.006,1.054,28.683,10.1,130.6,0.83,0.94,NA,4.53,8.91,72.6,205.9,0.1,134,0.09703320631464343,NA,NA,NA,976.8000000000001
181,2019-07-08,2019-07-08T17:47:55Z,1.109,1.129,28.665,10.09,130.5,0.89,0.93,NA,4.24,8.91,72.7,205.9,0.1,134,0.10689983669025585,NA,NA,NA,976.9333333333334
181,2019-07-08,2019-07-08T17:47:56Z,1.223,1.277,28.629,10.08,130.4,0.85,0.93,NA,4.3,8.91,72.7,206,0.1,134,0.11785519869352205,NA,NA,NA,976.8000000000001
181,2019-07-08,2019-07-08T17:47:57Z,1.321,1.327,28.608,10.08,130.2,0.8,0.94,NA,4.22,8.91,72.7,206.1,0.1,134,0.12738160043549265,NA,NA,NA,976.8000000000001
181,2019-07-08,2019-07-08T17:47:58Z,1.359,1.378,28.609,10.07,130.1,0.82,0.96,NA,4.24,8.9,72.7,206.1,0.1,134,0.1309880239520958,NA,NA,NA,976.9333333333334
181,2019-07-08,2019-07-08T17:48:00Z,1.42,1.431,28.603,10.06,130,0.8,0.93,NA,4.65,8.9,72.7,206.2,0.1,134,0.13690800217746327,NA,NA,NA,976.8000000000001
181,2019-07-08,2019-07-08T17:48:02Z,1.456,1.471,28.597,10.06,129.9,0.83,0.95,NA,4.5,8.9,72.8,206.2,0.1,134,0.1403783342406097,NA,NA,NA,976.8000000000001
181,2019-07-08,2019-07-08T17:48:03Z,1.489,1.497,28.595,10.06,129.9,0.86,0.92,NA,4.41,8.9,72.8,206.2,0.1,134,0.14350843767011431,NA,NA,NA,976.9333333333334
181,2019-07-08,2019-07-08T17:48:04Z,1.529,1.546,28.591,10.06,129.9,0.89,0.94,NA,4.39,8.9,72.8,206,0.1,134,0.14738704409363093,NA,NA,NA,976.8000000000001
181,2019-07-08,2019-07-08T17:48:05Z,1.564,1.579,28.586,10.05,129.8,0.86,0.95,NA,4.46,8.9,72.8,206.1,0.1,134,0.150789330430049,NA,NA,NA,976.8000000000001
181,2019-07-08,2019-07-08T17:48:06Z,1.608,1.62,28.583,10.05,129.7,0.78,0.96,NA,4.49,8.9,72.8,206.1,0.1,134,0.15500816548720742,NA,NA,NA,976.8000000000001
181,2019-07-08,2019-07-08T17:48:07Z,1.648,1.678,28.574,10.04,129.6,0.78,0.97,NA,4.56,8.9,72.9,206.1,0.1,134,0.158886771910724,NA,NA,NA,976.9333333333334
181,2019-07-08,2019-07-08T17:48:08Z,1.706,1.705,28.55,10.04,129.6,0.82,0.92,NA,4.37,8.9,72.9,206.2,0.1,134,0.16446652150244964,NA,NA,NA,976.9333333333334
181,2019-07-08,2019-07-08T17:48:09Z,1.731,1.753,28.498,10.02,129.3,0.85,0.98,NA,4.38,8.9,73,206.2,0.1,134,0.16691616766467066,NA,NA,NA,976.8000000000001
181,2019-07-08,2019-07-08T17:48:11Z,1.795,1.815,28.41,9.98,128.6,0.8,0.94,NA,4.37,8.89,73.2,206.7,0.1,134,0.1730402830702232,NA,NA,NA,976.9333333333334
181,2019-07-08,2019-07-08T17:48:12Z,1.846,1.883,28.369,9.94,127.9,0.81,0.91,NA,4.54,8.88,73.3,206.8,0.1,134,0.1780076211213936,NA,NA,NA,976.8000000000001
181,2019-07-08,2019-07-08T17:48:13Z,1.922,1.921,28.303,9.85,126.7,0.77,0.9,NA,4.42,8.87,73.5,207,0.1,135,0.18528851388132825,NA,NA,NA,976.8000000000001
181,2019-07-08,2019-07-08T17:48:14Z,1.95,1.968,28.254,9.77,125.6,0.73,0.9,NA,4.47,8.86,73.6,207.1,0.1,135,0.1880103429504627,NA,NA,NA,976.8000000000001
181,2019-07-08,2019-07-08T17:48:17Z,2.006,2.015,28.153,9.44,121,0.73,0.78,NA,4.28,8.81,74,207.7,0.1,135,0.19345400108873162,NA,NA,NA,976.9333333333334
181,2019-07-08,2019-07-08T17:48:18Z,2.024,2.054,28.111,9.33,119.6,0.75,0.81,NA,4.43,8.8,74.1,207.7,0.1,135,0.19515514425694067,NA,NA,NA,976.8000000000001
181,2019-07-08,2019-07-08T17:48:19Z,2.092,2.106,28.063,9.21,117.9,0.73,0.8,NA,4.32,8.79,74.1,207.8,0.1,135,0.20168753402286338,NA,NA,NA,976.9333333333334
181,2019-07-08,2019-07-08T17:48:20Z,2.129,2.135,27.995,9.12,116.6,0.74,0.79,NA,3.81,8.78,74.3,208,0.1,135,0.20522591181273817,NA,NA,NA,976.8000000000001
181,2019-07-08,2019-07-08T17:48:21Z,2.152,2.16,27.958,9.03,115.3,0.78,0.8,NA,4.02,8.77,74.3,208.1,0.1,135,0.20753946652150243,NA,NA,NA,976.9333333333334
181,2019-07-08,2019-07-08T17:48:23Z,2.196,2.213,27.912,8.83,112.8,0.77,0.74,NA,4.26,8.75,74.6,208.3,0.1,135,0.21169025585193252,NA,NA,NA,976.8000000000001
181,2019-07-08,2019-07-08T17:48:24Z,2.248,2.271,27.805,8.73,111.3,0.71,0.68,NA,3.8,8.73,74.8,208.7,0.1,136,0.21672563962983124,NA,NA,NA,976.8000000000001
181,2019-07-08,2019-07-08T17:48:25Z,2.297,2.303,27.747,8.59,109.4,0.67,0.67,NA,3.57,8.71,74.9,209,0.1,136,0.22148884050081655,NA,NA,NA,976.8000000000001
181,2019-07-08,2019-07-08T17:48:26Z,2.317,2.332,27.722,8.43,107.2,0.71,0.65,NA,3.57,8.69,75.1,209.1,0.1,136,0.223462166575939,NA,NA,NA,976.9333333333334
181,2019-07-08,2019-07-08T17:48:27Z,2.357,2.369,27.614,8.22,104.4,0.77,0.62,NA,3.67,8.65,75.4,209.5,0.1,136,0.22727272727272727,NA,NA,NA,976.8000000000001
181,2019-07-08,2019-07-08T17:48:28Z,2.394,2.41,27.512,8.02,101.7,0.79,0.59,NA,3.53,8.62,75.6,210,0.1,136,0.2308791507893304,NA,NA,NA,976.8000000000001
181,2019-07-08,2019-07-08T17:48:29Z,2.435,2.439,27.472,7.78,98.6,0.8,0.59,NA,3.25,8.59,75.8,210.1,0.1,137,0.23489384866630375,NA,NA,NA,976.9333333333334
181,2019-07-08,2019-07-08T17:48:32Z,2.474,2.482,27.44,7.24,91.6,0.84,0.57,NA,4.19,8.52,76.2,210.2,0.1,137,0.23856831790963526,NA,NA,NA,976.9333333333334
181,2019-07-08,2019-07-08T17:48:33Z,2.506,2.519,27.376,7.12,90,0.79,0.59,NA,3.73,8.51,76.2,210.6,0.1,137,0.2416984213391399,NA,NA,NA,976.8000000000001
181,2019-07-08,2019-07-08T17:48:34Z,2.537,2.542,27.368,7.03,88.9,0.78,0.56,NA,3.43,8.5,76.3,210.6,0.1,137,0.24462438758845947,NA,NA,NA,976.8000000000001
181,2019-07-08,2019-07-08T17:48:36Z,2.564,2.574,27.348,6.9,87.1,0.82,0.53,NA,3.29,8.48,76.4,210.7,0.1,137,0.2473462166575939,NA,NA,NA,976.9333333333334
181,2019-07-08,2019-07-08T17:48:37Z,2.604,2.619,27.283,6.82,86.1,0.75,0.5,NA,3.31,8.47,76.6,211,0.1,137,0.25108873162765377,NA,NA,NA,976.8000000000001
181,2019-07-08,2019-07-08T17:48:38Z,2.638,2.646,27.189,6.76,85.3,0.76,0.43,NA,3.13,8.45,76.8,211.4,0.1,137,0.25435492651061514,NA,NA,NA,976.8000000000001
181,2019-07-08,2019-07-08T17:48:39Z,2.66,2.667,27.151,6.66,83.9,0.93,0.47,NA,3.04,8.43,76.9,211.5,0.1,138,0.25660043549265105,NA,NA,NA,976.8000000000001
181,2019-07-08,2019-07-08T17:48:40Z,2.68,2.69,27.161,6.57,82.8,0.92,0.51,NA,3.21,8.42,77.1,211.5,0.1,137,0.2585057158410452,NA,NA,NA,976.8000000000001
181,2019-07-08,2019-07-08T17:48:41Z,2.715,2.739,27.168,6.48,81.6,0.79,0.46,NA,3.11,8.41,77.1,211.5,0.1,137,0.2618399564507349,NA,NA,NA,976.8000000000001
181,2019-07-08,2019-07-08T17:48:42Z,2.785,2.795,27.086,6.41,80.6,0.71,0.39,NA,3.27,8.4,77.2,211.6,0.1,138,0.2685764833968427,NA,NA,NA,976.8000000000001
181,2019-07-08,2019-07-08T17:48:43Z,2.814,2.823,26.835,6.34,79.6,0.68,0.36,NA,3.08,8.4,77.4,212.6,0.1,138,0.27143440391943385,NA,NA,NA,976.8000000000001
181,2019-07-08,2019-07-08T17:48:46Z,2.873,2.925,26.636,6.16,76.8,0.78,0.36,NA,2.6,8.36,78.2,213.4,0.1,139,0.27708219923788785,NA,NA,NA,976.9333333333334
181,2019-07-08,2019-07-08T17:48:47Z,2.985,3.012,26.585,6.02,75,0.67,0.24,NA,2.66,8.33,78.4,213.4,0.1,139,0.2879014697876973,NA,NA,NA,976.8000000000001
181,2019-07-08,2019-07-08T17:48:48Z,3.051,3.06,26.394,5.85,72.8,0.6,0.24,NA,2.78,8.29,78.7,214.1,0.1,139,0.29429776810016334,NA,NA,NA,976.8000000000001
181,2019-07-08,2019-07-08T17:48:50Z,3.09,3.098,26.241,5.43,67.2,0.75,0.21,NA,2.93,8.23,78.9,214.8,0.1,140,0.2981083287969516,NA,NA,NA,976.8000000000001
181,2019-07-08,2019-07-08T17:48:51Z,3.113,3.12,26.217,5.2,64.3,0.72,0.18,NA,2.7,8.21,79.1,214.9,0.1,140,0.30028579205225914,NA,NA,NA,976.9333333333334
181,2019-07-08,2019-07-08T17:48:54Z,3.15,3.158,26.177,4.63,57.3,0.65,0.18,NA,2.8,8.15,79.4,214.8,0.1,140,0.3038922155688623,NA,NA,NA,976.8000000000001
181,2019-07-08,2019-07-08T17:48:57Z,3.195,3.219,26.213,4.17,51.7,0.58,0.16,NA,2.82,8.11,79.8,214.2,0.1,139,0.30824714207947745,NA,NA,NA,976.8000000000001
181,2019-07-08,2019-07-08T17:48:58Z,3.253,3.274,26.117,4.07,50.3,0.52,0.17,NA,2.66,8.1,79.9,214.4,0.1,139,0.3137588459444747,NA,NA,NA,976.9333333333334
181,2019-07-08,2019-07-08T17:48:59Z,3.306,3.318,26.025,3.96,48.9,0.54,0.16,NA,2.88,8.09,80.2,214.6,0.1,140,0.3189303211758302,NA,NA,NA,976.8000000000001
181,2019-07-08,2019-07-08T17:49:00Z,3.334,3.338,25.992,3.86,47.6,0.58,0.18,NA,3.03,8.07,80.3,214.6,0.1,139,0.321720195971693,NA,NA,NA,976.8000000000001
181,2019-07-08,2019-07-08T17:49:01Z,3.354,3.363,25.99,3.73,46,0.61,0.18,NA,3.02,8.05,80.3,214.5,0.1,139,0.32355743059335873,NA,NA,NA,976.8000000000001
181,2019-07-08,2019-07-08T17:49:03Z,3.389,3.403,25.993,3.45,42.6,0.57,0.19,NA,2.87,8.01,80.4,214.4,0.1,139,0.3269597169297768,NA,NA,NA,976.8000000000001
181,2019-07-08,2019-07-08T17:49:04Z,3.424,3.435,25.964,3.34,41.1,0.58,0.21,NA,2.85,8,80.5,214.4,0.1,139,0.33029395753946655,NA,NA,NA,976.9333333333334
181,2019-07-08,2019-07-08T17:49:05Z,3.453,3.456,25.917,3.21,39.6,0.58,0.18,NA,2.83,7.98,80.6,214.6,0.1,139,0.3331518780620577,NA,NA,NA,976.8000000000001
181,2019-07-08,2019-07-08T17:49:07Z,3.49,3.494,25.778,2.99,36.7,0.58,0.11,NA,2.77,7.94,81,215,0.1,140,0.3366902558519325,NA,NA,NA,976.9333333333334
181,2019-07-08,2019-07-08T17:49:08Z,3.51,3.525,25.746,2.86,35.1,0.58,0.14,NA,2.82,7.93,81.3,215,0.1,140,0.33866358192705504,NA,NA,NA,976.9333333333334
181,2019-07-08,2019-07-08T17:49:09Z,3.549,3.568,25.674,2.7,33.1,0.65,0.13,NA,2.75,7.91,81.5,215.1,0.1,140,0.3424060968971149,NA,NA,NA,976.9333333333334
181,2019-07-08,2019-07-08T17:49:10Z,3.592,3.618,25.583,2.54,31.1,0.72,0.12,NA,2.94,7.9,81.7,215.5,0.1,140,0.34655688622754494,NA,NA,NA,976.9333333333334
181,2019-07-08,2019-07-08T17:49:11Z,3.659,3.676,25.503,2.36,28.8,0.74,0.13,NA,2.78,7.88,82,215.6,0.1,140,0.35302123026673926,NA,NA,NA,976.9333333333334
181,2019-07-08,2019-07-08T17:49:12Z,3.71,3.716,25.482,2.19,26.7,0.82,0.11,NA,2.77,7.86,82.2,215.5,0.1,140,0.3579205225911813,NA,NA,NA,976.9333333333334
181,2019-07-08,2019-07-08T17:49:13Z,3.729,3.748,25.429,2.01,24.5,0.85,0.08,NA,3.06,7.85,82.3,215.6,0.1,140,0.35982580293957545,NA,NA,NA,976.9333333333334
181,2019-07-08,2019-07-08T17:49:14Z,3.77,3.782,25.33,1.87,22.8,0.8,0.1,NA,3.16,7.83,82.5,215.9,0.1,140,0.36384050081654873,NA,NA,NA,976.8000000000001
181,2019-07-08,2019-07-08T17:49:16Z,3.807,3.819,25.258,1.61,19.6,0.82,0.09,NA,3.06,7.81,82.7,216.1,0.1,140,0.36737887860642354,NA,NA,NA,976.8000000000001
181,2019-07-08,2019-07-08T17:49:17Z,3.835,3.847,25.177,1.49,18.1,0.79,0.14,NA,2.98,7.8,82.8,216.3,0.1,141,0.3700326619488296,NA,NA,NA,976.8000000000001
181,2019-07-08,2019-07-08T17:49:18Z,3.864,3.872,25.125,1.39,16.9,0.8,0.13,NA,2.92,7.79,82.9,216.5,0.1,141,0.3728905824714208,NA,NA,NA,976.8000000000001
181,2019-07-08,2019-07-08T17:49:20Z,3.898,3.91,25.118,1.24,15,0.8,0.15,NA,2.88,7.77,83.1,216.5,0.1,141,0.37615677735438213,NA,NA,NA,976.8000000000001
181,2019-07-08,2019-07-08T17:49:21Z,3.924,3.934,25.01,1.16,14,0.73,0.09,NA,2.93,7.76,83.2,216.9,0.1,141,0.37867446924333154,NA,NA,NA,976.8000000000001
181,2019-07-08,2019-07-08T17:49:22Z,3.95,3.963,24.939,1.08,13.1,0.64,0.06,NA,2.79,7.75,83.4,217,0.1,141,0.3811241154055525,NA,NA,NA,976.8000000000001
181,2019-07-08,2019-07-08T17:49:23Z,3.986,4.008,24.858,1,12,0.63,0.04,NA,2.76,7.74,83.4,217,0.1,141,0.3847305389221557,NA,NA,NA,976.8000000000001
181,2019-07-08,2019-07-08T17:49:24Z,4.046,4.06,24.757,0.93,11.3,0.65,0.05,NA,3.05,7.73,83.5,216.8,0.1,141,0.3904463799673381,NA,NA,NA,976.8000000000001
181,2019-07-08,2019-07-08T17:49:25Z,4.08,4.086,24.662,0.88,10.6,0.69,0.08,NA,3.28,7.72,83.6,216.8,0.1,141,0.3937806205770278,NA,NA,NA,976.8000000000001
181,2019-07-08,2019-07-08T17:49:26Z,4.101,4.116,24.648,0.84,10.1,0.64,0.08,NA,3.25,7.71,83.7,216.7,0.1,141,0.3958219923788786,NA,NA,NA,976.8000000000001
181,2019-07-08,2019-07-08T17:49:27Z,4.137,4.163,24.592,0.79,9.5,0.55,0.07,NA,3.37,7.7,83.8,216.2,0.1,141,0.39929232444202506,NA,NA,NA,976.8000000000001
181,2019-07-08,2019-07-08T17:49:28Z,4.242,4.282,24.212,0.73,8.8,0.49,0.04,NA,3.6,7.7,84.1,216.4,0.1,141,0.4094311377245509,NA,NA,NA,976.8000000000001
181,2019-07-08,2019-07-08T17:49:29Z,4.325,4.328,23.753,0.69,8.2,0.43,0.03,NA,3.48,7.69,84.2,216.8,0.1,141,0.41746053347849754,NA,NA,NA,976.8000000000001
181,2019-07-08,2019-07-08T17:49:30Z,4.344,4.354,23.788,0.65,7.7,0.41,0.02,NA,3.21,7.68,84.3,216.6,0.1,141,0.41929776810016334,NA,NA,NA,976.8000000000001
181,2019-07-08,2019-07-08T17:49:31Z,4.381,4.405,23.753,0.61,7.2,0.42,0.02,NA,3.27,7.67,84.4,216.1,0.1,140,0.42290419161676646,NA,NA,NA,976.8000000000001
181,2019-07-08,2019-07-08T17:49:32Z,4.44,4.459,23.689,0.57,6.8,0.42,0.02,NA,3.28,7.66,84.5,216,0.1,140,0.42862003266194887,NA,NA,NA,976.8000000000001
181,2019-07-08,2019-07-08T17:49:33Z,4.494,4.511,23.593,0.55,6.5,0.43,0.06,NA,3.31,7.66,84.5,216.4,0.1,141,0.4337915078933043,NA,NA,NA,976.8000000000001
181,2019-07-08,2019-07-08T17:49:34Z,4.542,4.565,23.496,0.53,6.2,0.39,0.05,NA,3.28,7.65,84.7,216.8,0.1,141,0.43848666303756123,NA,NA,NA,976.8000000000001
181,2019-07-08,2019-07-08T17:49:35Z,4.599,4.62,23.453,0.5,5.9,0.38,0.02,NA,2.97,7.64,84.8,216.7,0.1,141,0.44399836690255856,NA,NA,NA,976.8000000000001
181,2019-07-08,2019-07-08T17:49:36Z,4.661,4.699,23.41,0.48,5.6,0.41,0.04,NA,3.01,7.63,84.9,216.6,0.1,141,0.44998639085465436,NA,NA,NA,976.8000000000001
181,2019-07-08,2019-07-08T17:49:37Z,4.773,4.798,23.347,0.46,5.4,0.4,0,NA,3.16,7.63,85.1,216.4,0.1,141,0.46080566140446383,NA,NA,NA,976.8000000000001
181,2019-07-08,2019-07-08T17:49:38Z,4.836,4.86,23.304,0.44,5.2,0.34,-0.03,NA,3.16,7.62,85.2,216.5,0.1,141,0.466861731083288,NA,NA,NA,976.8000000000001
181,2019-07-08,2019-07-08T17:49:39Z,4.902,4.924,23.323,0.43,5,0.3,0,NA,3.12,7.61,85.3,216.4,0.1,141,0.4731899836690256,NA,NA,NA,976.8000000000001
181,2019-07-08,2019-07-08T17:49:40Z,4.962,4.989,23.335,0.41,4.8,0.3,0,NA,3.07,7.6,85.3,216.2,0.1,141,0.4791099618943931,NA,NA,NA,976.8000000000001
181,2019-07-08,2019-07-08T17:49:41Z,5.036,5.048,23.215,0.4,4.6,0.29,0,NA,3.08,7.6,85.5,216.6,0.1,141,0.48625476320087097,NA,NA,NA,976.8000000000001
181,2019-07-08,2019-07-08T17:49:42Z,5.069,5.079,23.037,0.38,4.5,0.33,0,NA,3.26,7.59,85.7,217.2,0.1,141,0.4893848666303756,NA,NA,NA,976.8000000000001
181,2019-07-08,2019-07-08T17:49:43Z,5.1,5.114,23.025,0.37,4.4,0.33,-0.02,NA,3.52,7.58,85.7,217.2,0.1,141,0.4923788786064235,NA,NA,NA,976.8000000000001
181,2019-07-08,2019-07-08T17:49:44Z,5.147,5.177,22.931,0.36,4.2,0.29,-0.02,NA,3.94,7.57,85.8,217.1,0.1,141,0.49700598802395213,NA,NA,NA,976.8000000000001
181,2019-07-08,2019-07-08T17:49:45Z,5.218,5.223,22.754,0.35,4.1,0.29,-0.03,NA,4.09,7.57,85.9,217.2,0.1,141,0.5038786064235167,NA,NA,NA,976.8000000000001
181,2019-07-08,2019-07-08T17:49:46Z,5.243,5.26,22.588,0.34,4,0.28,-0.05,NA,4.12,7.56,86.1,217.3,0.1,141,0.5062602068590093,NA,NA,NA,976.8000000000001
181,2019-07-08,2019-07-08T17:49:47Z,5.285,5.298,22.448,0.34,3.9,0.29,-0.03,NA,4.53,7.56,86.3,216.9,0.1,141,0.5103429504627109,NA,NA,NA,976.8000000000001
181,2019-07-08,2019-07-08T17:49:48Z,5.319,5.334,22.271,0.33,3.7,0.29,-0.01,NA,4.5,7.56,86.4,217.3,0.1,141,0.5136091453456723,NA,NA,NA,976.8000000000001
181,2019-07-08,2019-07-08T17:49:49Z,5.374,5.391,22.156,0.32,3.7,0.26,-0.02,NA,4.88,7.55,86.6,217.2,0.1,141,0.5189847577572129,NA,NA,NA,976.8000000000001
181,2019-07-08,2019-07-08T17:49:50Z,5.416,5.431,22.041,0.31,3.5,0.27,-0.02,NA,4.78,7.54,86.6,217.1,0.1,141,0.52299945563418615,NA,NA,NA,976.8000000000001
181,2019-07-08,2019-07-08T17:49:51Z,5.453,5.463,21.963,0.3,3.4,0.26,-0.04,NA,4.35,7.54,86.8,217.5,0.1,141,0.5266058791507894,NA,NA,NA,976.8000000000001
181,2019-07-08,2019-07-08T17:49:52Z,5.479,5.491,21.887,0.3,3.4,0.25,-0.02,NA,4.56,7.53,86.8,217.8,0.1,142,0.5291235710397387,NA,NA,NA,976.8000000000001
181,2019-07-08,2019-07-08T17:49:53Z,5.516,5.527,21.859,0.29,3.3,0.25,-0.02,NA,4.77,7.53,87,217.6,0.1,141,0.5327299945563418,NA,NA,NA,976.8000000000001
181,2019-07-08,2019-07-08T17:49:54Z,5.544,5.555,21.912,0.29,3.3,0.25,-0.03,NA,4.75,7.52,87.1,217.5,0.1,141,0.5354518236254763,NA,NA,NA,976.9333333333334
181,2019-07-08,2019-07-08T17:49:55Z,5.591,5.64,21.912,0.28,3.2,0.23,-0.04,NA,5.05,7.51,87.2,217,0.1,141,0.5400108873162766,NA,NA,NA,976.8000000000001
181,2019-07-08,2019-07-08T17:49:56Z,5.687,5.695,21.742,0.27,3.1,0.22,-0.04,NA,4.98,7.51,87.3,216.7,0.1,141,0.5491970604246054,NA,NA,NA,976.9333333333334
181,2019-07-08,2019-07-08T17:49:57Z,5.714,5.72,21.661,0.27,3.1,0.24,-0.03,NA,4.95,7.51,87.4,216.9,0.1,141,0.5519188894937398,NA,NA,NA,976.9333333333334
181,2019-07-08,2019-07-08T17:49:58Z,5.734,5.747,21.671,0.27,3,0.25,0,NA,5.15,7.5,87.4,216.8,0.1,141,0.5537561241154055,NA,NA,NA,976.9333333333334
181,2019-07-08,2019-07-08T17:49:59Z,5.77,5.788,21.7,0.26,3,0.23,0,NA,5.3,7.49,87.5,216.4,0.1,141,0.557226456178552,NA,NA,NA,976.8000000000001
181,2019-07-08,2019-07-08T17:50:00Z,5.816,5.833,21.674,0.26,2.9,0.23,-0.03,NA,5.45,7.49,87.6,216,0.1,140,0.5616494284158955,NA,NA,NA,976.8000000000001
181,2019-07-08,2019-07-08T17:50:01Z,5.861,5.871,21.524,0.25,2.9,0.23,-0.05,NA,5.46,7.48,87.8,216.4,0.1,141,0.566072400653239,NA,NA,NA,976.9333333333334
181,2019-07-08,2019-07-08T17:50:02Z,5.897,5.923,21.443,0.25,2.8,0.2,-0.05,NA,5.36,7.48,87.9,216.7,0.1,141,0.5696107784431138,NA,NA,NA,976.8000000000001
181,2019-07-08,2019-07-08T17:50:03Z,5.96,5.985,21.316,0.24,2.7,0.19,-0.02,NA,5.52,7.47,88.1,216.1,0.1,140,0.575666848121938,NA,NA,NA,976.8000000000001
181,2019-07-08,2019-07-08T17:50:04Z,6.022,6.038,21.074,0.23,2.6,0.19,-0.01,NA,5.64,7.47,88.2,216.5,0.1,141,0.5817229178007621,NA,NA,NA,976.8000000000001
181,2019-07-08,2019-07-08T17:50:05Z,6.066,6.081,20.88,0.23,2.6,0.2,-0.02,NA,5.7,7.47,88.3,217.2,0.1,141,0.5859417528579206,NA,NA,NA,976.8000000000001
181,2019-07-08,2019-07-08T17:50:06Z,6.119,6.13,20.843,0.23,2.6,0.21,-0.04,NA,5.64,7.46,88.4,217.3,0.1,141,0.5911132280892759,NA,NA,NA,976.8000000000001
181,2019-07-08,2019-07-08T17:50:07Z,6.148,6.157,20.795,0.23,2.6,0.21,-0.04,NA,5.83,7.46,88.5,217.4,0.1,141,0.5939031028851388,NA,NA,NA,976.9333333333334
181,2019-07-08,2019-07-08T17:50:08Z,6.189,6.238,20.61,0.23,2.5,0.2,-0.01,NA,6.45,7.45,88.7,217.7,0.1,142,0.5978497550353837,NA,NA,NA,976.8000000000001
181,2019-07-08,2019-07-08T17:50:09Z,6.301,6.325,20.431,0.22,2.5,0.2,-0.04,NA,6.79,7.45,88.9,216.8,0.1,141,0.6087370713119216,NA,NA,NA,976.8000000000001
181,2019-07-08,2019-07-08T17:50:10Z,6.384,6.407,20.246,0.21,2.4,0.19,-0.07,NA,6.54,7.45,89,217.2,0.1,141,0.61669842133914,NA,NA,NA,976.8000000000001
181,2019-07-08,2019-07-08T17:50:11Z,6.437,6.454,20.17,0.21,2.3,0.2,-0.01,NA,6.37,7.44,89,217.6,0.1,141,0.6219379422972238,NA,NA,NA,976.8000000000001
181,2019-07-08,2019-07-08T17:50:12Z,6.473,6.477,20.159,0.21,2.3,0.21,-0.02,NA,6.45,7.44,89,217.6,0.1,141,0.6253402286336418,NA,NA,NA,976.8000000000001
181,2019-07-08,2019-07-08T17:50:14Z,6.542,6.572,20.181,0.2,2.2,0.2,-0.04,NA,6.75,7.43,89.2,217.1,0.1,141,0.6320087098530213,NA,NA,NA,976.9333333333334
181,2019-07-08,2019-07-08T17:50:15Z,6.613,6.635,19.753,0.19,2.1,0.16,-0.04,NA,6.77,7.43,89.4,218.5,0.1,142,0.6389493739793142,NA,NA,NA,976.8000000000001
181,2019-07-08,2019-07-08T17:50:16Z,6.661,6.672,19.513,0.19,2.1,0.15,-0.06,NA,6.91,7.42,89.5,219.1,0.1,142,0.6436445291235711,NA,NA,NA,976.8000000000001
181,2019-07-08,2019-07-08T17:50:17Z,6.692,6.695,19.491,0.19,2,0.16,-0.08,NA,6.9,7.42,89.6,219.1,0.1,142,0.6466385410996189,NA,NA,NA,976.8000000000001
181,2019-07-08,2019-07-08T17:50:18Z,6.712,6.728,19.514,0.19,2,0.17,-0.04,NA,6.92,7.41,89.6,219.1,0.1,142,0.6485438214480131,NA,NA,NA,976.8000000000001
181,2019-07-08,2019-07-08T17:50:19Z,6.761,6.794,19.512,0.18,2,0.19,0,NA,7.19,7.41,89.7,218.8,0.1,142,0.65323897659227,NA,NA,NA,976.8000000000001
181,2019-07-08,2019-07-08T17:50:20Z,6.838,6.854,19.346,0.18,1.9,0.17,0,NA,7.24,7.4,89.9,219.1,0.1,142,0.6607240065323898,NA,NA,NA,976.8000000000001
181,2019-07-08,2019-07-08T17:50:21Z,6.888,6.906,19.139,0.17,1.9,0.15,-0.02,NA,7.31,7.4,90,219.8,0.1,143,0.6655552531301034,NA,NA,NA,976.8000000000001
181,2019-07-08,2019-07-08T17:50:22Z,6.939,6.954,18.925,0.17,1.9,0.17,-0.02,NA,7.31,7.4,90.2,220.3,0.1,143,0.6705225911812738,NA,NA,NA,976.8000000000001
181,2019-07-08,2019-07-08T17:50:23Z,6.99,7.015,18.851,0.17,1.8,0.19,-0.02,NA,7.28,7.39,90.3,220.5,0.1,143,0.6754899292324442,NA,NA,NA,976.8000000000001
181,2019-07-08,2019-07-08T17:50:24Z,7.06,7.103,18.841,0.17,1.8,0.18,-0.05,NA,7.26,7.39,90.4,220.4,0.1,143,0.6822264561785519,NA,NA,NA,976.8000000000001
181,2019-07-08,2019-07-08T17:50:25Z,7.16,7.185,18.765,0.17,1.8,0.17,-0.03,NA,7.43,7.39,90.5,220.7,0.1,143,0.6918889493739793,NA,NA,NA,976.8000000000001
181,2019-07-08,2019-07-08T17:50:26Z,7.25,7.273,18.656,0.16,1.8,0.18,-0.04,NA,7.35,7.38,90.6,221.2,0.1,144,0.700666848121938,NA,NA,NA,976.8000000000001
181,2019-07-08,2019-07-08T17:50:27Z,7.302,7.317,18.543,0.16,1.7,0.17,-0.08,NA,7.32,7.38,90.8,221.6,0.11,144,0.7056341861731082,NA,NA,NA,976.8000000000001
181,2019-07-08,2019-07-08T17:50:28Z,7.34,7.355,18.505,0.16,1.7,0.16,-0.07,NA,7.56,7.37,90.8,221.7,0.11,144,0.7093767011431683,NA,NA,NA,976.8000000000001
181,2019-07-08,2019-07-08T17:50:29Z,7.374,7.376,18.599,0.15,1.6,0.17,-0.01,NA,7.76,7.37,90.8,221.3,0.1,144,0.7125748502994012,NA,NA,NA,976.8000000000001
181,2019-07-08,2019-07-08T17:50:30Z,7.389,7.413,18.646,0.15,1.7,0.16,-0.01,NA,7.56,7.37,90.8,221.2,0.1,144,0.7141399020141534,NA,NA,NA,976.8000000000001
181,2019-07-08,2019-07-08T17:50:31Z,7.46,7.475,18.518,0.15,1.6,0.14,-0.06,NA,7.59,7.36,90.9,221.6,0.11,144,0.7209444746869897,NA,NA,NA,976.8000000000001
181,2019-07-08,2019-07-08T17:50:32Z,7.491,7.498,18.418,0.15,1.6,0.15,-0.06,NA,7.74,7.35,91.1,222.1,0.11,144,0.724006532389766,NA,NA,NA,976.8000000000001
181,2019-07-08,2019-07-08T17:50:33Z,7.535,7.587,18.292,0.15,1.6,0.17,-0.05,NA,7.84,7.35,91.3,222.3,0.11,145,0.7282934131736527,NA,NA,NA,976.8000000000001
181,2019-07-08,2019-07-08T17:50:34Z,7.649,7.674,18.151,0.14,1.5,0.15,-0.04,NA,7.73,7.35,91.3,222.6,0.11,145,0.739248775176919,NA,NA,NA,976.8000000000001
181,2019-07-08,2019-07-08T17:50:35Z,7.745,7.767,18.107,0.14,1.5,0.16,-0.03,NA,7.59,7.34,91.3,222.9,0.11,145,0.7486390854654328,NA,NA,NA,976.9333333333334
181,2019-07-08,2019-07-08T17:50:36Z,7.801,7.818,18.072,0.14,1.5,0.17,-0.06,NA,7.65,7.34,91.4,223.3,0.11,145,0.7540146978769733,NA,NA,NA,976.8000000000001
181,2019-07-08,2019-07-08T17:50:37Z,7.849,7.884,17.982,0.14,1.5,0.16,-0.06,NA,8.04,7.33,91.5,223.5,0.11,145,0.7585737615677736,NA,NA,NA,976.8000000000001
181,2019-07-08,2019-07-08T17:50:38Z,7.957,8,17.894,0.14,1.4,0.15,-0.05,NA,8.2,7.33,91.6,223.7,0.11,145,0.7691208492106696,NA,NA,NA,976.8000000000001
181,2019-07-08,2019-07-08T17:50:39Z,8.06,8.084,17.863,0.13,1.4,0.16,-0.06,NA,7.89,7.33,91.6,223.8,0.11,145,0.7790555253130104,NA,NA,NA,976.8000000000001
181,2019-07-08,2019-07-08T17:50:40Z,8.121,8.145,17.84,0.13,1.3,0.17,-0.05,NA,7.63,7.32,91.6,224.1,0.11,146,0.7849074578116495,NA,NA,NA,976.9333333333334
181,2019-07-08,2019-07-08T17:50:41Z,8.184,8.213,17.747,0.13,1.3,0.16,-0.03,NA,7.68,7.32,91.7,224.4,0.11,146,0.791031573217202,NA,NA,NA,976.8000000000001
181,2019-07-08,2019-07-08T17:50:42Z,8.27,8.301,17.692,0.13,1.3,0.16,-0.04,NA,8.25,7.31,91.8,224.7,0.11,146,0.7993331518780621,NA,NA,NA,976.8000000000001
181,2019-07-08,2019-07-08T17:50:43Z,8.345,8.355,17.686,0.12,1.3,0.17,-0.03,NA,8.18,7.31,91.8,224.7,0.11,146,0.8066140446379967,NA,NA,NA,976.8000000000001
181,2019-07-08,2019-07-08T17:50:44Z,8.376,8.392,17.633,0.12,1.3,0.17,-0.02,NA,8.04,7.3,91.8,225,0.11,146,0.8096080566140447,NA,NA,NA,976.9333333333334
181,2019-07-08,2019-07-08T17:50:45Z,8.419,8.44,17.564,0.12,1.3,0.15,-0.03,NA,8.1,7.3,91.9,225.5,0.11,147,0.8138268916712031,NA,NA,NA,976.8000000000001
181,2019-07-08,2019-07-08T17:50:46Z,8.465,8.467,17.572,0.12,1.3,0.15,-0.05,NA,8.19,7.3,92.1,225.5,0.11,147,0.8182498639085466,NA,NA,NA,976.8000000000001
181,2019-07-08,2019-07-08T17:50:48Z,8.502,8.526,17.593,0.12,1.3,0.17,-0.02,NA,8.32,7.29,92.2,225.2,0.11,146,0.8218562874251497,NA,NA,NA,976.8000000000001
181,2019-07-08,2019-07-08T17:50:49Z,8.554,8.569,17.539,0.12,1.2,0.16,-0.06,NA,8.4,7.29,92.2,225.3,0.11,146,0.82682362547632,NA,NA,NA,976.8000000000001
181,2019-07-08,2019-07-08T17:50:50Z,8.601,8.636,17.466,0.12,1.2,0.14,-0.05,NA,8.06,7.29,92.4,225.5,0.11,147,0.8314507348938487,NA,NA,NA,976.8000000000001
181,2019-07-08,2019-07-08T17:50:51Z,8.687,8.717,17.364,0.11,1.2,0.14,-0.02,NA,7.81,7.28,92.5,225.8,0.11,147,0.8397523135547087,NA,NA,NA,976.8000000000001
181,2019-07-08,2019-07-08T17:50:52Z,8.754,8.769,17.294,0.11,1.2,0.15,-0.03,NA,7.8,7.28,92.6,226,0.11,147,0.8462166575939031,NA,NA,NA,976.8000000000001
181,2019-07-08,2019-07-08T17:50:53Z,8.812,8.849,17.265,0.11,1.2,0.15,-0.02,NA,7.95,7.28,92.7,226.2,0.11,147,0.8518644529123571,NA,NA,NA,976.8000000000001
181,2019-07-08,2019-07-08T17:50:54Z,8.914,8.977,17.213,0.11,1.2,0.14,-0.03,NA,7.97,7.27,92.8,226.5,0.11,147,0.8617310832879695,NA,NA,NA,976.8000000000001
181,2019-07-08,2019-07-08T17:50:55Z,9.061,9.093,17.118,0.11,1.1,0.15,-0.05,NA,7.64,7.27,92.9,227.1,0.11,148,0.8758845944474687,NA,NA,NA,976.8000000000001
181,2019-07-08,2019-07-08T17:50:56Z,9.168,9.185,17.02,0.11,1.1,0.16,-0.05,NA,7.33,7.27,92.9,227.6,0.11,148,0.886295590636908,NA,NA,NA,976.8000000000001
181,2019-07-08,2019-07-08T17:50:57Z,9.217,9.237,17.011,0.11,1.1,0.15,-0.04,NA,7.77,7.27,93,227.8,0.11,148,0.8910587915078934,NA,NA,NA,976.8000000000001
181,2019-07-08,2019-07-08T17:50:58Z,9.301,9.372,16.988,0.1,1.1,0.15,-0.03,NA,8.06,7.27,93.2,227.8,0.11,148,0.8990881872618399,NA,NA,NA,976.8000000000001
181,2019-07-08,2019-07-08T17:50:59Z,9.498,9.552,16.857,0.1,1,0.16,-0.06,NA,7.64,7.26,93.3,228.4,0.11,148,0.9182090364725095,NA,NA,NA,976.8000000000001
181,2019-07-08,2019-07-08T17:51:00Z,9.613,9.612,16.742,0.1,1,0.16,-0.05,NA,7.33,7.26,93.4,229.2,0.11,149,0.9293004899292324,NA,NA,NA,976.8000000000001
181,2019-07-08,2019-07-08T17:51:01Z,9.639,9.655,16.756,0.1,1,0.18,-0.05,NA,7.31,7.26,93.5,229.2,0.11,149,0.9318181818181819,NA,NA,NA,976.8000000000001
181,2019-07-08,2019-07-08T17:51:02Z,9.711,9.803,16.759,0.1,1,0.16,-0.06,NA,7.26,7.25,93.5,229.4,0.11,149,0.9388268916712031,NA,NA,NA,976.8000000000001
181,2019-07-08,2019-07-08T17:51:03Z,9.93,9.98,16.536,0.09,0.9,0.15,-0.04,NA,7.12,7.25,93.8,230.7,0.11,150,0.9600571584104518,NA,NA,NA,976.8000000000001
181,2019-07-08,2019-07-08T17:51:04Z,10.075,10.103,16.386,0.09,0.9,0.16,-0.04,NA,6.91,7.25,93.9,232.1,0.11,151,0.9740745781164942,NA,NA,NA,976.8000000000001
181,2019-07-08,2019-07-08T17:51:05Z,10.145,10.154,16.339,0.09,0.9,0.15,-0.07,NA,6.61,7.24,94,232.4,0.11,151,0.980811105062602,NA,NA,NA,976.8000000000001
181,2019-07-08,2019-07-08T17:51:06Z,10.18,10.194,16.336,0.09,0.9,0.15,-0.07,NA,6.76,7.24,94,232.6,0.11,151,0.9842814371257486,NA,NA,NA,976.8000000000001
181,2019-07-08,2019-07-08T17:51:07Z,10.226,10.253,16.355,0.09,0.9,0.15,-0.04,NA,7.2,7.24,94,232.6,0.11,151,0.988704409363092,NA,NA,NA,976.8000000000001
181,2019-07-08,2019-07-08T17:51:08Z,10.301,10.319,16.313,0.09,0.9,0.15,-0.03,NA,6.89,7.24,94.1,233.1,0.11,152,0.9959853021230267,NA,NA,NA,976.8000000000001
181,2019-07-08,2019-07-08T17:51:09Z,10.353,10.374,16.173,0.08,0.8,0.16,-0.03,NA,6.75,7.23,93.9,234.1,0.11,152,1.000952640174197,NA,NA,NA,976.8000000000001
181,2019-07-08,2019-07-08T17:51:10Z,10.402,10.42,16.137,0.08,0.8,0.15,-0.03,NA,6.46,7.23,93.3,234.5,0.11,152,1.005647795318454,NA,NA,NA,976.9333333333334
181,2019-07-08,2019-07-08T17:51:11Z,10.466,10.491,16.012,0.08,0.8,0.23,0.17,NA,11.95,7.22,92.2,237.1,0.11,154,1.0119080021774634,NA,NA,NA,976.8000000000001
181,2019-07-08,2019-07-08T17:51:12Z,10.526,10.54,15.868,0.08,0.8,0.39,0.45,NA,194.49,7.21,89.9,239.5,0.11,156,1.0177599346761024,NA,NA,NA,976.8000000000001
181,2019-07-08,2019-07-08T17:51:13Z,10.56,10.567,15.835,0.08,0.8,0.69,0.93,NA,173.18,7.2,87.3,240.6,0.11,156,1.0210261295590637,NA,NA,NA,976.8000000000001
181,2019-07-08,2019-07-08T17:51:14Z,10.581,10.59,15.828,0.07,0.7,0.79,0.95,NA,80.2,7.19,85,241.6,0.12,157,1.0230675013609145,NA,NA,NA,976.8000000000001
181,2019-07-08,2019-07-08T17:51:15Z,10.607,10.614,15.835,0.07,0.7,0.65,0.6,NA,66.84,7,82.9,242.2,0.12,157,1.0256532389765922,NA,NA,NA,976.8000000000001
181,2019-07-08,2019-07-08T17:51:16Z,10.63,10.636,15.844,0.07,0.7,0.66,0.86,NA,61.89,6.96,80.9,242.3,0.12,158,1.0278307022319,NA,NA,NA,976.8000000000001
