MULakeNumber,date,dateTime,depth_m,verticalPosition_m,temp_degC,doConcentration_mgpL,doSaturation_percent,chlorophyll_RFU,phycocyaninBGA_RFU,phycoerythrinTAL_RFU,turbidity_FNU,pH,orp_mV,specificConductivity_uSpcm,salinity_psu,tds_mgpL,waterPressure_barA,latitude,longitude,altitude_m,barometerAirHandheld_mbars
115,2020-07-15,2020-07-15T15:17:42Z,0.255,0.258,28.732,6.82,88.3,1.97,1.24,NA,5.66,7.84,199.8,131.7,0.06,86,0.025,39.70841,-91.86185,208.9,985.1
115,2020-07-15,2020-07-15T15:17:54Z,0.331,0.375,28.769,6.51,84.3,1.88,1.21,NA,5.54,7.82,201.2,131.9,0.06,86,0.032,39.7084,-91.86186,209.3,985.1
115,2020-07-15,2020-07-15T15:17:55Z,0.426,0.457,28.772,6.5,84.2,1.83,1.11,NA,5.54,7.83,201.1,131.9,0.06,86,0.042,39.7084,-91.86186,209.2,985.1
115,2020-07-15,2020-07-15T15:17:56Z,0.494,0.52,28.774,6.5,84.1,1.84,1.17,NA,5.56,7.83,201,131.9,0.06,86,0.048,39.70841,-91.86186,208.9,985.1
115,2020-07-15,2020-07-15T15:17:57Z,0.575,0.598,28.776,6.49,84.1,1.89,1.27,NA,5.6,7.83,200.9,131.9,0.06,86,0.056,39.70841,-91.86186,208.5,985
115,2020-07-15,2020-07-15T15:17:58Z,0.629,0.642,28.776,6.49,84,1.99,1.16,NA,5.79,7.83,200.8,131.9,0.06,86,0.061,39.70841,-91.86186,208.3,985
115,2020-07-15,2020-07-15T15:17:59Z,0.673,0.703,28.775,6.48,84,2.03,1.12,NA,5.62,7.83,200.6,131.9,0.06,86,0.066,39.70841,-91.86186,208,985.1
115,2020-07-15,2020-07-15T15:18:00Z,0.741,0.767,28.774,6.48,83.9,1.99,1.19,NA,5.56,7.84,200.4,131.9,0.06,86,0.072,39.70841,-91.86186,208.1,985.1
115,2020-07-15,2020-07-15T15:18:01Z,0.815,0.833,28.773,6.47,83.8,2,1.18,NA,5.67,7.84,200.2,131.9,0.06,86,0.08,39.70841,-91.86185,208.1,985.1
115,2020-07-15,2020-07-15T15:18:02Z,0.859,0.869,28.771,6.46,83.7,1.97,1.17,NA,5.56,7.84,200,131.9,0.06,86,0.084,39.70841,-91.86185,208,985.1
115,2020-07-15,2020-07-15T15:18:03Z,0.894,0.915,28.769,6.46,83.7,1.95,1.19,NA,5.52,7.85,199.8,132,0.06,86,0.087,39.70841,-91.86185,208.1,985.2
115,2020-07-15,2020-07-15T15:18:04Z,0.946,0.966,28.765,6.45,83.6,2.04,1.24,NA,5.51,7.85,199.6,132,0.06,86,0.092,39.70841,-91.86185,208.2,985.1
115,2020-07-15,2020-07-15T15:18:05Z,0.994,1.009,28.762,6.45,83.5,2.03,1.24,NA,5.49,7.85,199.3,132,0.06,86,0.097,39.70841,-91.86185,208.3,985.1
115,2020-07-15,2020-07-15T15:18:06Z,1.032,1.049,28.762,6.44,83.4,1.98,1.23,NA,5.4,7.86,199,132,0.06,86,0.101,39.70841,-91.86185,208.4,985.1
115,2020-07-15,2020-07-15T15:18:07Z,1.076,1.085,28.763,6.44,83.4,2,1.33,NA,5.46,7.86,198.8,132,0.06,86,0.105,39.70841,-91.86185,208.3,985.2
115,2020-07-15,2020-07-15T15:18:10Z,1.135,1.153,28.766,6.43,83.3,2.01,1.24,NA,5.51,7.88,197.9,132,0.06,86,0.111,39.70842,-91.86184,208.1,985.1
115,2020-07-15,2020-07-15T15:18:13Z,1.186,1.201,28.77,6.43,83.3,2.01,1.2,NA,5.62,7.89,197.2,132,0.06,86,0.116,39.70842,-91.86184,208.1,985.1
115,2020-07-15,2020-07-15T15:18:14Z,1.221,1.235,28.768,6.43,83.3,1.93,1.18,NA,5.7,7.89,197.1,132,0.06,86,0.119,39.70842,-91.86184,208.2,985.2
115,2020-07-15,2020-07-15T15:18:16Z,1.278,1.295,28.76,6.43,83.2,1.9,1.22,NA,5.55,7.9,196.6,132.1,0.06,86,0.125,39.70843,-91.86184,208.2,985.1
115,2020-07-15,2020-07-15T15:18:17Z,1.34,1.368,28.761,6.42,83.1,1.91,1.23,NA,5.75,7.9,196.6,132.1,0.06,86,0.131,39.70843,-91.86184,208.1,985.1
115,2020-07-15,2020-07-15T15:18:18Z,1.426,1.45,28.761,6.41,83,2.03,1.2,NA,5.9,7.9,196.6,132.1,0.06,86,0.139,39.70843,-91.86184,208,985.1
115,2020-07-15,2020-07-15T15:18:19Z,1.485,1.504,28.76,6.41,83,2.06,1.1,NA,5.7,7.9,196.5,132.1,0.06,86,0.145,39.70844,-91.86184,208,985.1
115,2020-07-15,2020-07-15T15:18:20Z,1.533,1.549,28.758,6.4,82.9,2.04,1.14,NA,5.6,7.91,196.3,132.1,0.06,86,0.15,39.70844,-91.86184,208,985.1
115,2020-07-15,2020-07-15T15:18:21Z,1.574,1.587,28.756,6.4,82.9,2.05,1.25,NA,5.47,7.91,196.2,132.1,0.06,86,0.154,39.70844,-91.86184,208,985.1
115,2020-07-15,2020-07-15T15:18:22Z,1.612,1.621,28.755,6.39,82.8,2.04,1.17,NA,5.62,7.91,196.1,132.1,0.06,86,0.158,39.70844,-91.86184,208.1,985.1
115,2020-07-15,2020-07-15T15:18:23Z,1.655,1.678,28.752,6.39,82.7,2.04,1.11,NA,5.89,7.91,196.1,132.2,0.06,86,0.162,39.70844,-91.86184,208.2,985.1
115,2020-07-15,2020-07-15T15:18:24Z,1.716,1.749,28.749,6.38,82.6,2.04,1.12,NA,5.95,7.91,196.2,132.2,0.06,86,0.168,39.70844,-91.86184,208.3,985.1
115,2020-07-15,2020-07-15T15:18:25Z,1.8,1.839,28.745,6.37,82.5,2.05,1.15,NA,5.89,7.91,196.3,132.3,0.06,86,0.176,39.70843,-91.86184,208.1,985.2
115,2020-07-15,2020-07-15T15:18:26Z,1.886,1.913,28.741,6.36,82.4,2.09,1.18,NA,5.87,7.91,196.4,132.3,0.06,86,0.184,39.70843,-91.86184,208.1,985
115,2020-07-15,2020-07-15T15:18:27Z,1.97,1.983,28.738,6.35,82.2,2.08,1.19,NA,5.86,7.91,196.4,132.4,0.06,86,0.192,39.70843,-91.86184,208.2,985.1
115,2020-07-15,2020-07-15T15:18:28Z,2.011,2.023,28.736,6.34,82.1,2.08,1.2,NA,5.89,7.91,196.2,132.4,0.06,86,0.196,39.70843,-91.86184,208.1,985.1
115,2020-07-15,2020-07-15T15:18:29Z,2.046,2.055,28.734,6.33,81.9,2.18,1.19,NA,5.75,7.91,196.1,132.4,0.06,86,0.2,39.70843,-91.86184,208.1,985.1
115,2020-07-15,2020-07-15T15:18:30Z,2.073,2.085,28.733,6.32,81.8,2.23,1.19,NA,5.64,7.91,196,132.4,0.06,86,0.203,39.70843,-91.86184,208.2,985.1
115,2020-07-15,2020-07-15T15:18:31Z,2.123,2.148,28.73,6.31,81.7,2.22,1.15,NA,5.75,7.91,195.9,132.5,0.06,86,0.207,39.70843,-91.86184,208,985.1
115,2020-07-15,2020-07-15T15:18:32Z,2.176,2.193,28.728,6.3,81.5,2.09,1.12,NA,5.84,7.91,195.8,132.5,0.06,86,0.212,39.70843,-91.86183,208.1,985.1
115,2020-07-15,2020-07-15T15:18:33Z,2.22,2.243,28.726,6.29,81.4,1.97,1.14,NA,5.67,7.91,195.7,132.5,0.06,86,0.217,39.70843,-91.86184,208,985.3
115,2020-07-15,2020-07-15T15:18:34Z,2.273,2.302,28.723,6.27,81.2,1.88,1.17,NA,5.51,7.91,195.7,132.6,0.06,86,0.222,39.70843,-91.86184,207.8,985.1
115,2020-07-15,2020-07-15T15:18:35Z,2.345,2.358,28.715,6.26,81.1,1.88,1.21,NA,5.66,7.91,195.8,132.7,0.06,86,0.229,39.70843,-91.86183,207.7,985.1
115,2020-07-15,2020-07-15T15:18:36Z,2.395,2.413,28.701,6.24,80.8,1.89,1.24,NA,5.76,7.9,195.9,132.8,0.06,86,0.234,39.70843,-91.86184,207.9,985.2
115,2020-07-15,2020-07-15T15:18:37Z,2.449,2.462,28.68,6.21,80.4,1.76,1.14,NA,5.66,7.9,196,133.1,0.06,86,0.239,39.70842,-91.86184,207.9,985.2
115,2020-07-15,2020-07-15T15:18:38Z,2.49,2.499,28.661,6.17,79.8,1.65,0.97,NA,5.53,7.89,196.1,133.2,0.06,87,0.243,39.70842,-91.86184,207.8,985.1
115,2020-07-15,2020-07-15T15:18:39Z,2.523,2.544,28.656,6.13,79.3,1.68,0.98,NA,5.6,7.89,196,133.3,0.06,87,0.246,39.70842,-91.86184,207.8,985.2
115,2020-07-15,2020-07-15T15:18:40Z,2.573,2.585,28.647,6.09,78.8,1.72,1.02,NA,5.78,7.88,196,133.3,0.06,87,0.251,39.70842,-91.86184,207.8,985.1
115,2020-07-15,2020-07-15T15:18:41Z,2.61,2.622,28.631,6.05,78.2,1.57,0.97,NA,5.75,7.87,196,133.3,0.06,87,0.255,39.70842,-91.86184,207.8,985.2
115,2020-07-15,2020-07-15T15:18:42Z,2.651,2.668,28.607,5.98,77.2,1.39,0.96,NA,5.82,7.85,196,133.4,0.06,87,0.259,39.70842,-91.86184,207.8,985.1
115,2020-07-15,2020-07-15T15:18:43Z,2.702,2.72,28.553,5.88,75.9,1.35,0.95,NA,6.06,7.84,196,133.6,0.06,87,0.264,39.70842,-91.86184,207.7,985.1
115,2020-07-15,2020-07-15T15:18:44Z,2.765,2.781,28.486,5.34,68.9,1.35,0.78,NA,6.01,7.83,196.1,133.7,0.06,87,0.27,39.70841,-91.86184,207.7,985.1
115,2020-07-15,2020-07-15T15:18:45Z,2.815,2.829,28.433,4.88,62.8,1.31,0.72,NA,5.77,7.81,196.1,133.6,0.06,87,0.275,39.70841,-91.86184,207.8,985.1
115,2020-07-15,2020-07-15T15:18:46Z,2.861,2.877,28.371,4.36,56.1,1.21,0.75,NA,5.51,7.78,196.1,133.4,0.06,87,0.279,39.70841,-91.86184,207.8,985.2
115,2020-07-15,2020-07-15T15:18:47Z,2.903,2.919,28.322,4.08,52.5,1.2,0.64,NA,5.53,7.75,196.1,133.1,0.06,87,0.284,39.70841,-91.86184,207.8,985.1
115,2020-07-15,2020-07-15T15:18:48Z,2.95,2.961,28.231,3.55,45.6,1.24,0.62,NA,5.54,7.73,196.1,133,0.06,86,0.288,39.70841,-91.86185,207.8,985.2
115,2020-07-15,2020-07-15T15:18:49Z,3,3.024,28.103,3.16,40.6,1.29,0.67,NA,5.39,7.7,196.2,132.6,0.06,86,0.293,39.70841,-91.86185,207.9,985.1
115,2020-07-15,2020-07-15T15:18:50Z,3.065,3.086,27.997,2.73,34.9,1.38,0.66,NA,5.56,7.68,196.3,131.8,0.06,86,0.299,39.70841,-91.86185,208,985.1
115,2020-07-15,2020-07-15T15:18:51Z,3.122,3.135,27.911,2.48,31.7,1.64,0.69,NA,6.22,7.65,196.3,131.4,0.06,85,0.305,39.7084,-91.86185,208.1,985.1
115,2020-07-15,2020-07-15T15:18:52Z,3.182,3.198,27.741,2.02,25.8,1.72,0.82,NA,6.52,7.63,196.4,131.3,0.06,85,0.311,39.7084,-91.86185,208.2,985.2
115,2020-07-15,2020-07-15T15:18:53Z,3.232,3.243,27.597,1.72,21.8,1.6,1.09,NA,6.7,7.61,196.5,131.1,0.06,85,0.316,39.7084,-91.86184,208.1,985.2
115,2020-07-15,2020-07-15T15:18:54Z,3.273,3.284,27.171,1.49,18.8,1.6,1.47,NA,7.44,7.59,196.8,131.9,0.06,86,0.32,39.7084,-91.86184,208.1,985.1
115,2020-07-15,2020-07-15T15:18:55Z,3.311,3.323,26.754,1.31,16.4,1.59,1.6,NA,7.92,7.56,197.3,133.5,0.06,87,0.324,39.7084,-91.86184,208.1,985.2
115,2020-07-15,2020-07-15T15:18:56Z,3.356,3.389,25.186,1.25,15.5,1.52,1.28,NA,8.61,7.54,197.9,138.4,0.06,90,0.328,39.7084,-91.86184,208.1,985.2
115,2020-07-15,2020-07-15T15:18:57Z,3.442,3.453,24.626,1.13,13.7,1.48,0.99,NA,8.94,7.51,198.7,142.6,0.07,93,0.337,39.7084,-91.86184,208.1,985.1
115,2020-07-15,2020-07-15T15:18:58Z,3.49,3.504,23.768,1.03,12.2,1.34,0.77,NA,9.48,7.5,199.2,148,0.07,96,0.341,39.7084,-91.86184,208.2,985.2
115,2020-07-15,2020-07-15T15:18:59Z,3.543,3.563,22.996,0.91,10.6,1.1,0.47,NA,10.68,7.49,199.4,154.4,0.07,100,0.347,39.7084,-91.86184,208.2,985.2
115,2020-07-15,2020-07-15T15:19:00Z,3.61,3.633,22.709,0.8,9.3,0.99,0.23,NA,11.34,7.47,199.9,157.3,0.07,102,0.353,39.70841,-91.86184,208.1,985.2
115,2020-07-15,2020-07-15T15:19:01Z,3.688,3.707,21.956,0.72,8.2,0.92,0.22,NA,11.62,7.47,199.8,159.9,0.07,104,0.361,39.70841,-91.86184,208.1,985.2
115,2020-07-15,2020-07-15T15:19:02Z,3.741,3.761,21.54,0.66,7.5,0.86,0.2,NA,13.39,7.48,199.2,161.4,0.08,105,0.366,39.70841,-91.86184,208.1,985.1
115,2020-07-15,2020-07-15T15:19:03Z,3.803,3.825,21.081,0.6,6.8,0.8,0.19,NA,14.26,7.47,187.5,161.7,0.08,105,0.372,39.70841,-91.86184,208.1,985.1
115,2020-07-15,2020-07-15T15:19:04Z,3.873,3.898,20.553,0.56,6.3,0.67,0.12,NA,13.72,7.45,174.5,161.6,0.08,105,0.379,39.70841,-91.86183,208,985.1
115,2020-07-15,2020-07-15T15:19:05Z,3.943,3.966,20.004,0.52,5.8,0.58,0.04,NA,13.18,7.42,162,160.4,0.08,104,0.386,39.70842,-91.86183,208,985.1
115,2020-07-15,2020-07-15T15:19:06Z,3.995,4.016,19.625,0.5,5.5,0.56,0,NA,13.01,7.4,150.9,159.6,0.08,104,0.391,39.70842,-91.86183,207.9,985.1
115,2020-07-15,2020-07-15T15:19:07Z,4.046,4.078,19.253,0.47,5.1,0.48,0.02,NA,12.93,7.39,136.4,159.3,0.07,104,0.396,39.70842,-91.86183,207.9,985.1
115,2020-07-15,2020-07-15T15:19:08Z,4.108,4.122,18.942,0.44,4.8,0.43,0.08,NA,13.1,7.38,124.5,159.2,0.07,103,0.402,39.70842,-91.86183,207.9,985.2
115,2020-07-15,2020-07-15T15:19:09Z,4.149,4.174,18.731,0.42,4.5,0.47,0.09,NA,13.3,7.36,111.8,158.8,0.07,103,0.406,39.70842,-91.86183,207.8,985.2
115,2020-07-15,2020-07-15T15:19:10Z,4.223,4.241,18.444,0.4,4.3,0.46,0.1,NA,13.56,7.35,97.9,159,0.07,103,0.414,39.70842,-91.86183,207.9,985.2
115,2020-07-15,2020-07-15T15:19:11Z,4.272,4.29,18.134,0.38,4,0.45,0.05,NA,14.19,7.33,84.8,159.4,0.08,104,0.418,39.70842,-91.86183,208,985.2
115,2020-07-15,2020-07-15T15:19:12Z,4.316,4.341,17.968,0.37,3.9,0.46,0.02,NA,14.12,7.33,73.4,159.6,0.08,104,0.423,39.70842,-91.86183,208,985.1
115,2020-07-15,2020-07-15T15:19:13Z,4.374,4.401,17.743,0.35,3.7,0.42,0.04,NA,14.3,7.31,61.1,159.1,0.08,103,0.428,39.70842,-91.86183,208,985.1
115,2020-07-15,2020-07-15T15:19:14Z,4.449,4.472,17.437,0.33,3.5,0.4,0.06,NA,15.21,7.3,49.5,158.4,0.07,103,0.436,39.70842,-91.86183,208,985.1
115,2020-07-15,2020-07-15T15:19:15Z,4.512,4.53,17.017,0.32,3.3,0.39,0.05,NA,15.79,7.29,38.1,158.8,0.07,103,0.442,39.70842,-91.86183,207.9,985.1
115,2020-07-15,2020-07-15T15:19:16Z,4.573,4.592,16.649,0.3,3.1,0.41,0.05,NA,16.72,7.27,26.6,160,0.08,104,0.448,39.70842,-91.86183,208,985.1
115,2020-07-15,2020-07-15T15:19:17Z,4.627,4.639,16.296,0.29,3,0.42,0.1,NA,17.03,7.26,17,161,0.08,105,0.453,39.70842,-91.86183,208,985.1
115,2020-07-15,2020-07-15T15:19:18Z,4.683,4.703,16.134,0.28,2.9,0.42,0.1,NA,17.14,7.24,3.4,161.3,0.08,105,0.459,39.70842,-91.86183,207.9,985.3
115,2020-07-15,2020-07-15T15:19:19Z,4.724,4.738,16.008,0.28,2.8,0.43,0.08,NA,17.27,7.24,-7,161.3,0.08,105,0.463,39.70842,-91.86182,208,985.2
115,2020-07-15,2020-07-15T15:19:20Z,4.758,4.794,15.946,0.27,2.7,0.45,0.07,NA,17.27,7.23,-15.6,161.3,0.08,105,0.466,39.70842,-91.86182,208,985.3
115,2020-07-15,2020-07-15T15:19:21Z,4.833,4.859,15.842,0.26,2.6,0.43,0.05,NA,17.09,7.22,-20.3,161.1,0.08,105,0.473,39.70842,-91.86182,208.1,985.2
115,2020-07-15,2020-07-15T15:19:22Z,4.904,4.921,15.758,0.25,2.5,0.41,0.04,NA,17.36,7.21,-30.1,161,0.08,105,0.48,39.70842,-91.86182,208,985.2
115,2020-07-15,2020-07-15T15:19:23Z,4.964,4.988,15.683,0.24,2.5,0.41,0.01,NA,17.59,7.2,-36.8,161.3,0.08,105,0.486,39.70842,-91.86182,207.9,985.2
115,2020-07-15,2020-07-15T15:19:24Z,5.03,5.058,15.565,0.24,2.4,0.4,-0.01,NA,17.49,7.19,-42,162,0.08,105,0.493,39.70842,-91.86182,207.9,985.1
115,2020-07-15,2020-07-15T15:19:25Z,5.095,5.131,15.485,0.23,2.3,0.43,0.06,NA,17.37,7.18,-44.7,162.9,0.08,106,0.499,39.70842,-91.86182,207.8,985.1
115,2020-07-15,2020-07-15T15:19:26Z,5.166,5.194,15.386,0.22,2.2,0.46,0.05,NA,17.3,7.17,-46.8,163.7,0.08,106,0.506,39.70842,-91.86182,207.7,985.1
115,2020-07-15,2020-07-15T15:19:27Z,5.231,5.24,15.296,0.21,2.1,0.48,0,NA,17.24,7.16,-50.8,164.7,0.08,107,0.512,39.70842,-91.86182,207.6,985.1
115,2020-07-15,2020-07-15T15:19:28Z,5.261,5.272,15.241,0.21,2.1,0.43,0.01,NA,17.6,7.15,-54.7,165.3,0.08,107,0.515,39.70842,-91.86182,207.6,985.2
115,2020-07-15,2020-07-15T15:19:29Z,5.296,5.309,15.21,0.2,2,0.38,0,NA,17.67,7.14,-58.2,165.6,0.08,108,0.519,39.70842,-91.86182,207.6,985.2
115,2020-07-15,2020-07-15T15:19:30Z,5.325,5.348,15.195,0.2,2,0.41,0.08,NA,17.44,7.14,-61,165.7,0.08,108,0.522,39.70842,-91.86182,207.4,985.3
115,2020-07-15,2020-07-15T15:19:31Z,5.385,5.401,15.173,0.2,1.9,0.41,0.14,NA,17.28,7.13,-63,165.8,0.08,108,0.528,39.70842,-91.86182,207.2,985.2
115,2020-07-15,2020-07-15T15:19:32Z,5.434,5.452,15.111,0.19,1.9,0.42,0.08,NA,17.43,7.13,-64.8,166,0.08,108,0.532,39.70842,-91.86182,207.3,985.1
115,2020-07-15,2020-07-15T15:19:33Z,5.486,5.506,15.061,0.19,1.9,0.46,0.02,NA,17.63,7.12,-66.4,166.3,0.08,108,0.537,39.70842,-91.86182,207.3,985.2
115,2020-07-15,2020-07-15T15:19:34Z,5.538,5.555,15.014,0.18,1.8,0.44,0.02,NA,17.66,7.11,-67.9,166.7,0.08,108,0.543,39.70842,-91.86182,207.2,985.3
115,2020-07-15,2020-07-15T15:19:35Z,5.594,5.612,14.983,0.18,1.8,0.4,-0.02,NA,17.67,7.11,-69.3,167,0.08,109,0.548,39.70842,-91.86182,207.1,985.2
115,2020-07-15,2020-07-15T15:19:36Z,5.64,5.669,14.883,0.17,1.7,0.4,0.01,NA,17.69,7.1,-70.5,167.6,0.08,109,0.553,39.70842,-91.86182,207.1,985.2
115,2020-07-15,2020-07-15T15:19:37Z,5.709,5.737,14.791,0.17,1.7,0.44,0.05,NA,17.58,7.1,-71.3,168.5,0.08,109,0.559,39.70842,-91.86182,207.2,985.2
115,2020-07-15,2020-07-15T15:19:38Z,5.772,5.799,14.727,0.17,1.7,0.42,0.05,NA,17.48,7.09,-72.1,169,0.08,110,0.566,39.70842,-91.86182,207.2,985.3
115,2020-07-15,2020-07-15T15:19:39Z,5.831,5.852,14.655,0.16,1.6,0.43,0,NA,17.02,7.08,-72.9,169.7,0.08,110,0.571,39.70842,-91.86182,207.1,985.2
115,2020-07-15,2020-07-15T15:19:40Z,5.89,5.906,14.562,0.16,1.6,0.45,-0.04,NA,16.83,7.08,-73.5,170.5,0.08,111,0.577,39.70842,-91.86182,207.1,985.1
115,2020-07-15,2020-07-15T15:19:41Z,5.935,5.952,14.467,0.16,1.5,0.44,0.05,NA,16.85,7.08,-74,171.5,0.08,111,0.582,39.70841,-91.86182,207.1,985.2
115,2020-07-15,2020-07-15T15:19:42Z,5.982,5.995,14.403,0.15,1.5,0.44,0.06,NA,16.91,7.07,-74.5,172.4,0.08,112,0.586,39.70841,-91.86182,207.4,985.2
115,2020-07-15,2020-07-15T15:19:43Z,6.023,6.042,14.351,0.15,1.5,0.45,0.05,NA,16.98,7.07,-74.8,173.6,0.08,113,0.59,39.70841,-91.86182,207.4,985.2
115,2020-07-15,2020-07-15T15:19:44Z,6.095,6.124,14.227,0.15,1.5,0.41,0.05,NA,16.95,7.06,-75,175.4,0.08,114,0.597,39.70841,-91.86182,207.5,985.2
115,2020-07-15,2020-07-15T15:19:45Z,6.167,6.182,14.143,0.15,1.4,0.37,0.04,NA,16.86,7.06,-75.2,177.8,0.08,116,0.604,39.70841,-91.86182,207.6,985.2
115,2020-07-15,2020-07-15T15:19:46Z,6.214,6.226,14.053,0.14,1.4,0.41,0.06,NA,16.8,7.05,-75.4,179.9,0.09,117,0.609,39.7084,-91.86182,207.8,985.2
115,2020-07-15,2020-07-15T15:19:47Z,6.258,6.275,13.974,0.14,1.4,0.38,0.09,NA,16.34,7.04,-75.6,181.8,0.09,118,0.613,39.7084,-91.86182,207.9,985.2
115,2020-07-15,2020-07-15T15:19:48Z,6.322,6.35,13.941,0.14,1.3,0.38,0.1,NA,15.88,7.03,-75.8,183.5,0.09,119,0.62,39.7084,-91.86182,208,985.1
115,2020-07-15,2020-07-15T15:19:49Z,6.382,6.398,13.86,0.13,1.3,0.45,0.07,NA,15.86,7.03,-76,186,0.09,121,0.625,39.7084,-91.86182,208.2,985.2
115,2020-07-15,2020-07-15T15:19:50Z,6.429,6.446,13.807,0.13,1.3,0.45,0.08,NA,15.51,7.02,-76.1,187.3,0.09,122,0.63,39.7084,-91.86181,208.3,985.1
115,2020-07-15,2020-07-15T15:19:51Z,6.48,6.498,13.747,0.13,1.2,0.47,0.06,NA,15.22,7.01,-76.4,188.8,0.09,123,0.635,39.7084,-91.86181,208.5,985.1
115,2020-07-15,2020-07-15T15:19:52Z,6.531,6.547,13.699,0.13,1.2,0.47,0.04,NA,15.21,7.01,-76.7,190.1,0.09,124,0.64,39.7084,-91.86181,208.6,985.2
115,2020-07-15,2020-07-15T15:19:53Z,6.581,6.586,13.639,0.12,1.2,0.5,0.11,NA,15.78,7,-76.9,191,0.09,124,0.645,39.7084,-91.86181,208.8,985.1
115,2020-07-15,2020-07-15T15:19:55Z,6.618,6.629,13.623,0.12,1.2,2.62,1.28,NA,30.94,6.99,-77.5,191.9,0.09,125,0.649,39.7084,-91.86181,208.9,985.1
115,2020-07-15,2020-07-15T15:19:57Z,6.664,6.672,13.615,0.12,1.2,1.19,0.74,NA,4.78,6.98,-77.8,193,0.09,125,0.653,39.70839,-91.86181,208.8,985.1
115,2020-07-15,2020-07-15T15:20:01Z,6.724,6.737,13.59,0.12,1.1,0.53,0.25,NA,14.42,6.97,-78.1,195.1,0.09,127,0.659,39.7084,-91.86181,208.8,985.2
